1111111111
1S00101001
1010000101
1010000T11
1001010001
1011111101
1000000111
1111111111
